бсбсбсбсбсбсбсбс                        
бс    бу      бс                        
бс            бс                        
бс            бс                        
бс            бс                        
бс            бс                        
бс            бс                        
бс            бс                        
бс            бс                        
бс            бс                        
бс            бс                        
бс            бс                        
бс            бс                        
бс            бс                        
бс            бс                        
бс            бс                        
бс            бс                        
бс            бс                        
бс    и╤      бс                        
бсбсбсбсбсбсбсбс                 