бсбсбсбсбсбсбсбсбсбсбсбсбсбсбсбсбсбсбсбс
бс              и╨                    бс
бс  и╫          бс                    бс
бсбсбсбс        бсбсбсбсбсбсбсбсбс    бс
бс    бс        бс      бс      бс    бс
бси╫  бс        бс      бс      бс    бс
бс    бс        бс      бс      бс    бс
бс    и╨        бс      бс      бс    бс
бс    бс        бс      бс      бс    бс
бс    бс        бс      бс      бс    бс
бс    бс        бс      бс      бс    бс
бс    бс        бс      бс      бс    бс
бс    бс  и╥      бс  бс        бс    бс
бс    бс            бс          бс    бс
бси╫бс      бс              и╨    бси╤бс
бсбс      бси╫бс          бс  бс    бсбс
бс      бс      бс      бс      бс    бс
бсбсбсбс          бсбсбс          бс  бс
бсбу                                бсбс
бсбсбсбсбсбсбсбсбсбсбсбсбсбсбсбсбсбсбсбс         