бсбсбсбсбсбсбсбсбсбсбсбсбсбсбсбсбсбсбсбс
бс          и╫бсбсбсбсбсбс            бс
бс          бс    бсбс    бс          бс
бс      бси╨      бсбс        бс      бс
бси╥  бс          бсбс          бс    бс
бс    бс          бсбс          бс    бс
бс  бс            бсбс            бс  бс
бсбубс                            бси╫бс
бсбсбсбсбсбсбсбсбсбс                бсбс
бсбс                                бсбс
бсбс                                бсбс
бсбс                бсбсбсбсбсбсбсбсбсбс
бс  бс            бсбс                бс
бс  и╫            бсбс            бс  бс
бс    бс          бсбс          бс    бс
бс    бс          бсбс          бс    бс
бс      бсбс      бсбс      бсбс      бс
бс          бс    и╨и╨    бс          бс
бс            бсбсбсбсбсбс          и╤бс
бсбсбсбсбсбсбсбсбсбсбсбсбсбсбсбсбсбсбсбс