бсбсбсбсбсбсбсбсбсбсбсбсбсбсбсбсбсбсбсбс
бс                  бс                бс
бс                  бс                бс
бс  бсбси╨бс        бс    бсбсбсбсбс  бс
бс  бс      бс      бс    бс          бс
бс  бс      и╨бс    бс    бс          бс
бс  бс    бс    бс        бс      бсбсбс
бс  бс      бс  бс        бс      бс  бс
бс  бс      бс  бс        бс      бс  бс
бс  бс      бс  бс        бс      бс  бс
бс  бс      бс  бси╫    и╫бс      бс  бс
бс  бс      бс  бсбсбсбсбсбс      бс  бс
бс  бс      бс                    бс  бс
бс  бс        бсбсбсбсбсбсбс      бс  бс
бс  бс      бси╫        и╫бс      бс  бс
бси╫бс      бс            бс      бс  бс
бсбсбс      бсбсбс    бсбсбс      бсбсбс
бс                    бс    и╨и╨и╨    бс
бсбуи╥          бс    бс    и╨и╨и╨  и╤бс
бсбсбсбсбсбсбсбсбсбсбсбсбсбсбсбсбсбсбсбс