бсбсбсбсбсбсбсбсбсбсбсбсбсбсбсбсбсбсбсбс
бс              бсбсбсбс              бс
бс          бсбс        бсбс          бс
бс                                    бс
бс    бс                        бс    бс
бс    бс                        бс    бс
бс  бс      бс            бс      бс  бс
бси╫бс      бс            бс      бси╫бс
бсбс        бси╫        и╫бс        бсбс
бсбс        бсбсбсбсбсбсбсбс        бсбс
бсбс        бсбсбсбсбсбсбсбс        бсбс
бсбс              и╫      и╨        бсбс
бс  бс                    бс      бс  бс
бс  бс      бс            бс      бс  бс
бс    бсбсбс              бс    бс    бс
бс    бс  и╨              бси╨и╨бс    бс
бс                и╨      бси╨и╨    и╨бс
бс          бсбс        бсбс      и╨  бс
бсбу            бсбсбсбс        и╨  и╤бс
бсбсбсбсбсбсбсбсбсбсбсбсбсбсбсбсбсбсбсбс 